WWWWWWWWWWWWWWWWWWWWWWWWWWWWWWWWWWWWWWWWWWWWWWWWWWWWWWWWWWWWWWWW
W00000000000000000000000000000000000000000000000000000000000000W
W00000000000000000000000000000000000000000000000000000000000000W
W00000000000000000000000000000000000000000000000000000000000000W
W00000000000000000000000000000000000000000000000000000000000000W
W00000000000000000000000000000000000000000000000000000000000000W
W00000000000000000000000000000000000000000000000000000000000000W
W00000000000000000000000000000000000000000000000000000000000000W
W00000000000000000000000000000000000000000000000000000000000000W
W00000000000000000000000000000000000000000000000000000000000000W
W00000000000000000000000000000000000000000000000000000000000000W
W00000000000000000000000000000000000000000000000000000000000000W
W00000000000000000000000000000000000000000000000000000000000000W
W00000000000000000000000000000000000000000000000000000000000000W
W00000000000000000000000000000000000000000000000000000000000000W
W00000000000000000000000000000000000000000000000000000000000000W
W00000000000000000000000000000000000000000000000000000000000000W
W00000000000000000000000000000000000000000000000000000000000000W
W00000000000000000000000000000000000000000000000000000000000000W
W00000000000000000000000000000000000000000000000000000000000000W
W00000000000000000000000000000000000000000000000000000000000000W
W00000000000000000000000000000000000000000000000000000000000000W
W00000000000000000000000000000000000000000000000000000000000000W
W00000000000000000000000000000000000000000000000000000000000000W
W00000000000000000000000000000000000000000000000000000000000000W
W000000000000000000E0000000000000000000000000000000000000000000W
W000000000000000WWWWWW00000000000000000000000000000000000000000W
W00000000000000000000000000000000000000000000000000000000000000W
W00000000000000000000000000000000000000000000000000000000000000W
W0000000E000000000000000000000000000000000000000000000000000000W
W000WWWWWW000000000WWWWWW00000000000000000000WWWWWWWW0000000000W
W00000000000000000000000000000000000000000000000000000000000000W
W00000000000000000000000000E00000000000000000000000000000000000W
W0000000000000000000000WWWWWWWW00000000000000000000000000000000W
W00000000000000000000000000000000000000000000000000000000000000W
W00000000000000000000000000000000000000000000000000000000000000W
W0000000WWWWWWWWWWWWWW00000000000000000000000000000000000000000W
W0000000000000000000000000000WWWWWWWWWW000000000000000000000000W
W00000000000000000000000000000000000000000000000000000000000000W
W000000000000000000000000000000000000000000WWWWWWWWW00000000000W
W00000000000000000000000000000000000000000000000000000000000000W
W00000000000000000000000000000000000000000000000000WWWWW0000000W
W0000000000000000000000000000000000WWWWWW00000000000000000WWWW0W
W00000000000000000000E00000000000000000000000000000000000000000W
W000000000000WWWWWWWWWWWWWWWW0000000000000000000000000000000000W
W00000000000000000000000000000000000000000000000000WWWW00000000W
W00000000000000000000000000000000000000000000000000000000000000W
WWWWWWWWWWWWWWWWWWWWWWWWWWWWWWWWWWWWWWWWWWWWWWWWWWWWWWWWWWWWWWWW